############
#        O #
#     P ####
#          
#######    
#  O ##    
#    ##    
#                           #
#      XX  #
#      #   #
############
